革命	かくめい	revolution, 58th year of the sexagenary cycle (in Onmyōdō), Revolution
生み出し	うみだす	to create, to invent, to give birth to
基地	きち	base (military, expedition, etc.)
文	ぶん	sentence, composition, the literary arts (as opposed to the military arts), statement
強固	きょうこ	firm
硝酸	しょうさん	nitric acid, Nitric acid
進出	しんしゅつ	advance (into a new market or stage of progress)
霊長	れいちょう	crown (of creation)
無	む	nothing, un-
続け	つづける	to continue
耐え	たえる	to bear, to support, to be fit for
躍進	やくしん	making rapid progress
順調	じゅんちょう	favourable
ウエット	ウェット	wet, soft-hearted
こう	こう	to beg
猛烈	もうれつ	fierce
外殻	がいかく	shell
生み出す	うみだす	to create, to invent, to give birth to
人類	じんるい	mankind
伴い	ともない	companion
能力	のうりょく	ability
限界	げんかい	limit
急激	きゅうげき	sudden
強力	きょうりょく	powerful
持っ	もっていく	to take
海	うみ	sea, Sea
重	じゅう	jūbako, heavy, serious, -fold
訪れる	おとずれる	to visit, to arrive (season, time, situation, etc.), to make a sound, to send a letter
ため	ため	good, sake, consequence, affecting
持ち込ま	もちこむ	to take something into ..., to lodge (a complaint), to bring to (a state: tied game, vote, trial, etc.)
線	せん	line, line (e.g. telephone line), ray (e.g. X-ray), line (e.g. of a railroad), outline, level, division, line (of action), impression one leaves
通過	つうか	passing through (a tunnel, station, town, etc.), passage (of a bill, e.g. through parliament), passing (an examination, inspection, etc.)
上昇	じょうしょう	rising
いったん	いったん	once, for a short time, one morning, Ittan
スケール	スケール	scale, Scale
棚	たな	shelf, trellis
外角	がいかく	external angle, outside corner
天	てん	sky, heaven, God, svarga (heaven-like realm visited as a stage of death and rebirth), deva (divine being of Buddhism), top (of a book), sole (of a Japanese sandal), beginning, tempura, India, Tian
及ん	きゅうだいてん	passing mark
欠泉	あくび	yawn, kanji "yawning" radical (radical 76)
未来	みらい	the future (usually distant), future tense, the world to come, Future
駆動	くどう	driving force
たい	たい	sea bream (Sparidae), tai (species of reddish-brown Pacific sea bream, Pagrus major), Sparidae
厳しい	きびしい	severe, hard (to do), intense (e.g. cold)
触媒	しょくばい	catalyst, Catalysis
公転	こうてん	revolution (of heavens)
洋	なだ	open sea
変え	かえ	changing
高知	こうち	Kōchi (city, prefecture)
所	ところ	place, address, district, one's house, point, passage (in text), space, thing, whereupon, about to, was just doing
噴火	ふんか	eruption, Vulcanian eruption
帯	おび	obi, paper wrapper on books, CDs, etc., band, cingulum, radio or television program broadcast in the same time slot on all or most days, Obi (sash)
プルーム	プルーム	plume, Plume
活性	かっせい	active
散逸	さんいつ	being scattered and ultimately lost, dissipation, Dissipation
極寒	ごっかん	extreme cold
産業	さんぎょう	industry, livelihood, Sangyou, Industry
広告	こうこく	advertisement, announcement, Advertising
技術	ぎじゅつ	technology, technique, art
分身	ぶんしん	other self, incarnations of Buddha
火山	かざん	volcano, Volcano
見える	みえる	to be seen, to look, to come
下がっ	さがる	to come down, to hang, to move back, to deteriorate, to get closer to the present day, to go south
領域	りょういき	area
南極	なんきょく	South Pole, the Antarctic, Antarctica, Antarctic
凍結	とうけつ	freezing (e.g. water), freezing (prices, wages, assets, etc.)
言語	げんご	language, Language
旋回	せんかい	revolution, turning (an aircraft or ship)
点	てん	dot, mark (in an exam, etc.), point (in a game), point (in geometry), point, (punctuation) mark (e.g. comma, period, decimal point), "dot" stroke (in a Chinese character), counter for points, marks, goals, etc., counter for goods, items, articles of clothing, works of art, etc.
勢い	いきおい	force, influence, impetus, naturally
放出	ほうしゅつ	release
ええ	ええ	yes, um, huh?, grrr, good
構成	こうせい	composition
蒸発	じょうはつ	evaporation, disappearance (of people intentionally concealing their whereabouts), Evaporation
全	ぜん	all, complete (set)
高く	たかくつく	to be expensive
生存	せいぞん	existence, to exist
裁判	さいばん	trial
行う	おこなう	to perform
提供	ていきょう	offer, sponsoring (a TV program)
物々	ぶつぶつこうかん	bartering, Barter
時	とき	time, occasion, chance, the times, tense, Autumn
き	き	tree, wood, Tree
なくなっ	ない	nonexistent, unowned, unique, not, not, to not be
バクテリア	バクテリア	bacteria
多数	たすう	large number (of), majority
縮退	しゅくたい	degeneracy, degradation (CPU, memory, etc.), Degenerate energy levels
被子	ひししょくぶつ	angiosperm, Flowering plant
頃	ころ	(approximate) time, suitable time (or condition), time of year
効率	こうりつ	efficiency
参加	さんか	participation
水域	すいいき	waters, Body of water
多様	たよう	diverse
小学	しょうがく	elementary school, school for children over eight years old in ancient China, traditional Chinese philology
いっ	いっち	coincidence, conformity, cooperation, Icchi, Agreement (linguistics)
士	さむらい	warrior (esp. of military retainers of daimyos in the Edo period), man in attendance (on a person of high standing)
兆	ちょう	10^12, sign
大きく	おおきく	in a big way
塩分	えんぶん	salt
い	い	stomach, Chinese "stomach" constellation (one of the 28 mansions), Stomach
誇っ	ほこる	to boast of
いく	いく	to go, to proceed, to pass through, to walk, to die, to do (in a specific way), to stream, to continue, to have an orgasm, to trip
一部	いちぶ	one part, one copy (e.g. of a document)
子	こ	child, young (animal), young woman, offshoot, interest, new shares, player who is not a dealer (in cards, mahjong, etc.), bird egg, -er (often of young women)
冠	かんむり	traditional cap worn by Shinto clergy and courtiers, crown, top kanji radical, first verse of a haikai, etc., best, name, Crown (headgear)
次	つぎ	next, stage
一種	いっしゅ	species
酷寒	こっかん	severe cold
多少	たしょう	a little, amount
力	ちから	force, capability, efficacy, effort, power, support, stress, means, Force
沈み込ん	しずむ	to sink, to go down (e.g. sun), to feel depressed
携帯	けいたい	carrying (on one's person or in the hand), mobile phone
領土	りょうど	dominion
始まり	はじまり	origin
対し	たいして	for
すべて	すべて	everything, entirely
近傍	きんぼう	neighborhood, neighborhood
多く	おおく	many, majority (of), mostly
液体	えきたい	liquid, Liquid
アミノ	アミノ	amino
厚	あつ	thickness
水準	すいじゅん	level, water level
帯びる	おびる	to wear (sword, decoration, etc.), to be entrusted (e.g. with a mission), to have a trace of
膨張	ぼうちょう	expansion
春歌	しゅんか	bawdy song
昆虫	こんちゅう	insect, Insect
真核	しんかくせいぶつ	eukaryote, Eukaryote
温暖	おんだん	warm
山荘	さんそう	mountain villa, Sansou
栓	せん	stopper, tap
つか	つか	mound, burial mound, Mound
迎えよう	むかえる	to go out to meet, to receive, to accept (e.g. as a member of a group or family), to call for, to approach (a certain time, a point in one's life, etc.)
残し	のこしゆ	leaving water in the bathtub (to use later for laundry)
距離	きょり	distance, Distance
著書	ちょしょ	(written) work
我々	われわれ	we
あっ	あっ	ah, hey!, A (kana)
させ	させつ	turning to the left
重合	じゅうごう	polymerization
編	へん	compilation (of a text), volume (of a text), completed literary work
暗	あん	darkness
逆らっ	さからう	to go against
浸食	しんしょく	erosion
いき	いき	breath, tone
はぎ取ら	はぎとる	to tear off
ない	ない	nonexistent, unowned, unique, not, not, to not be
省	しょう	ministry, province (of China), saving, Ministry (government department)
シアノ	シアノコバラミン	cyanocobalamin, Vitamin B12
食料	しょくりょう	food
届か	とどかぬねがい	unfulfilled wish
デー	デー	day (as in holiday), daytime
整然	せいぜん	orderly
計画	けいかく	plan, Plan
成功	せいこう	success
運核	うん	fortune, Luck
わかる	わかる	to understand, to become clear, I know!
気候	きこう	climate, Climate
銀河	ぎんが	Milky Way, galaxy, Galaxy
会得	えとく	understanding
含水	がんすい	hydrated
人工	じんこう	artificial, Artificial
時点	じてん	point in time
戻っ	もどってくる	to come back
ウサギ	うさぎ	rabbit, Rabbit
繋がっ	つながる	to be tied together, to lead to, to be related (by blood)
まるで	まるで	quite, as if
海洋	かいよう	ocean, Kaiyou
消滅	しょうめつ	extinction, annihilation
落下	らっか	fall
急増	きゅうぞう	rapid increase
戦略	せんりゃく	strategy, Strategy
御許	みもと	(his) side
正体	しょうたい	true character, consciousness
り	り	advantage
誕生	たんじょう	birth, Birth
課題	かだい	subject, homework, task
インド	インド	India
総局	そうきょく	head office
続ける	つづける	to continue
生かし	いかす	to make (the best) use of, to let live, to revive, to restore (a deleted passage; in proofreading)
付近	ふきん	neighborhood, approaching
供給	きょうきゅう	supply
意識	いしき	consciousness, becoming aware (of), mano-vijnana (mental consciousness, cognizer of sensory information), Consciousness
簡易	かんい	simplicity
あつまり	あつまり	gathering
剤	ざい	medicine
風呂	ふろ	bath, bathhouse, room for drying lacquerware, base (wooden joint connecting the blade of a hoe, spade, etc., to the handle), Bathtub
半数	はんすう	half the number, haploid
なくなり	なくなる	to be lost (e.g. luggage), to be used up, to disappear (e.g. pain)
与え	あたえ	gift
意味	いみ	meaning, Meaning (linguistics)
形作る	かたちづくる	to form
ドライ	ドライ	dry, dry (tone, humour, etc.), dry (of alcohol), Dry
ざる	ざる	not, Zaru
とても	とても	very, (not) at all
新しい	あたらしい	new
時代	じだい	period, the times, oldness, antique
紛失	ふんしつ	loss
国民	こくみん	people (of a country), Nation
赤鉄	せきてっこう	hematite, Hematite
あり	あり	ant
し	し	poem, Poetry
新	しん	new, newness, Gregorian calendar, Xin dynasty (China, 9-23 CE), Xin Dynasty
経	たて	the vertical, front-to-back, north-to-south, vertical (relationship), (weaving) warp
従え	したがえる	to be accompanied by, to conquer
直径	ちょっけい	diameter
小	しょう	smallness, short month (i.e. having fewer than 31 days), elementary school, smaller (of two things, places, etc. with the same name), younger (of two people with the same name), unit of field area (approx. 400 sq m)
ようやく	ようやく	finally, barely, gradually
また	また	again, also, on the other hand, and, or, really, indirect
海中	かいちゅう	in the sea
半島	はんとう	peninsula, Korea, Peninsula
シェール	シェール	shale, Cher (France), Cher
繰り返し	くりかえし	repetition, repeatedly
超	ちょう	super-, extremely, over
がっ	がっこう	school, Gakkou, School
内	うち	inside, while (e.g. one is young), among, in (secret, chaos, poverty, etc.), within oneself, we, one's home, my spouse, signed on behalf of (husband's name) by his wife, I, imperial palace grounds, emperor
移動	いどう	movement, mobile
迎え	むかえ	meeting
流	りゅう	fashion, school (of thought), class, current (electrical, water, etc.)
星	ほし	star (usu. not including the Sun), star (glyph, symbol, shape), star (actor, player, etc.), small dot, star point (in go), perp, bullseye, one's star (that determines one's fate), point
性	せい	nature (of a person), sex, gender, -ty
億	おく	10^8
生	なま	raw, natural, unprotected (sex), live (i.e. not recorded), inexperienced, impudence, unpasteurized beer, blank (e.g. disk), just a little, insufficient, cash, tipsiness
届く	とどく	to reach, to be delivered, to be attentive, to be realized (of a desire)
せ	せ	back, reverse, height, ridge (of a mountain)
新た	あらた	new
化	か	action of making something
鉱層	こうそう	ore bed
示し	しめし	lesson, revelation
整え	ととのえ	preparation
あるいは	あるいは	or, maybe, some ... and others ...
公演	こうえん	public performance, exhibition in a foreign country
繰り返す	くりかえす	to repeat
退席	たいせき	leaving one's seat
つつ	つつ	while, even though
ピーク	ピーク	peak, peek, Peak
必要	ひつよう	necessary, necessity
低地	ていち	depression, Lowland
広げ	ひろげる	to spread, to unfold, to scatter about, to make flourish
素	もと	origin, base, cause, ingredient, (somebody's) side, original cost (or capital, principal, etc.), (plant) root, first section of a waka, counter for blades of grass, tree trunks, etc., and for falcons (in falconry), handle (chopsticks, brush, etc.), Book
主	しゅじん	head (of a household), one's husband, (one's) employer, host
生産	せいさん	production, Outline of industrial organization
た	た	rice field, Paddy field
運気	うんき	fate
水	みず	water (esp. cool, fresh water, e.g. drinking water), fluid (esp. in an animal tissue), flood, water offered to wrestlers just prior to a bout, break granted to wrestlers engaged in a prolonged bout, Water
分離	ぶんり	separation
堆積	たいせき	accumulation, sedimentation, Sedimentation
数	すう	several, quantity, counting, number, grammatical number, destiny
体	からだ	body, torso, build, health, corpse
内部	ないぶ	interior
光	ひかり	light, illumination, happiness, influence, vision, Light
つけ	つけ	bill, tab (for later payment), contact move (in go), sound effect produced by striking with clappers a wooden board in kabuki, letter, reason, one's fortune
映像	えいぞう	image (on a screen), video, reflection, image (in one's mind), Footage
しがみつい	しがみつく	to cling
カンブリア	カンブリア	Cambria (old name for Wales)
すでに	すでに	already
作用	さよう	action
析出	せきしゅつ	separation, Deposition (chemistry)
黄金	おうごん	gold (Au), golden, money (esp. ōban coin), Gold
ディー	ディー	D, director
考え	かんがえ	thinking, idea, intention, consideration, wish
適用	てきよう	applying (e.g. a technology)
つ	つ	indicates two contrasting actions, indicates possessive (often found in place names and compound words), Tsu (kana)
小片	しょうへん	small piece
記述	きじゅつ	description
系	けい	system, corollary, system (range of strata that correspond to a particular time period), (taxonomical) series
満ち引き	みちひき	ebb and flow
や	や	arrow, wedge, Ya, Arrow
て	て	hand, forepaw, handle, hand, trouble, means, hand, kind, one's hands, ability to cope, hand (of cards), direction, move (in go, shogi, etc.), Te, Hand
ネズミ	ねずみ	mouse, dark gray, Muroidea
続い	つづいて	subsequently, after ...
戦	いくさ	war, troops
度	ど	degree (angle, temperature, scale, etc.), counter for occurrences, strength (of glasses), alcohol content (percentage), extent, presence of mind
選択	せんたく	selection
蒸気	じょうき	steam, steamboat, Vapor
情報	じょうほう	information, information, Information
消え	きえる	to go out
進歩	しんぽ	progress, Progress (history)
下回る	したまわる	to fall below (esp. figures: profits, unemployment rate, etc.)
現在	げんざい	now, Present
宇宙	うちゅう	universe, Universe
ベール	ベール	veil
個	こ	counter for articles, counter for military units, individual
音楽	おんがく	music, Music
かけ	かけ	credit, money owed on an account, hot noodles in broth, proportion (of wholesale price, as tenths of list price), in the midst of, rest
日中	にっちゅう	daytime, Japan and China, Nicchuu
自由	じゆう	freedom, Liberty
この	この	this, last (couple of years, etc.), you (as in "you liar")
有利	ゆうり	advantageous, profitable
最終	さいしゅう	last
応用	おうよう	(practical) application, applied
近世	きんせい	recent past, early modern period (from the Azuchi-Momoyama period to the end of the Edo period), Early modern period
噴出	ふんしゅつ	spewing
変異	へんい	variation
いう	いう	to say, to name, to go (e.g. "the alarm went ping")
共進	きょうしんか	coevolution, Coevolution
絶え間	たえま	interval, gap (e.g. in the clouds)
飛来	ひらい	coming flying in (migratory birds, airborne sand, pollen, etc.), coming by airplane
くる	くる	to come (spatially or temporally), to come back, to come to be, to come from, to come to (i.e. "when it comes to spinach ...")
源	みなもと	source (of a river), source
に	に	two
せる	セル	cell, serge, cel (celluloid), Cell
画期	かっき	transition from one epoch to another
つながっ	つなぐ	to connect, to tie, to maintain, to transfer (phone call), to hedge
構造	こうぞう	structure
惑星	わくせい	planet, Wakusei, Planet
回避	かいひ	evasion
進め	すすめる	to advance, to carry forward (plans, work, etc.), to raise
祖先	そせん	ancestor
名	な	name, title, fame, pretext
全て	すべて	everything, entirely
複雑	ふくざつ	complex
月	つき	moon, month, Moon
同じ	おなじ	same, anyway
だ	だ	be, did, please
なく	なく	to make sound (of an animal), to make a meld call (e.g. pung, kong)
悔恨	かいこん	regret
異なる	ことなる	to differ
育ん	いくえいしきん	scholarship, educational fund
ごく	ごく	words
風	かぜ	wind, manner, cold
起こり	おこり	source
遠い	とおい	far, distant (past), distant (relationship or kinship), far (from something else in quality, degree, etc.), hard (of hearing), nearsighted
中米	ちゅうべい	Central America, Chuubei
前	ぜん	last (i.e. immediately preceding), pre- (e.g. premodern), before, before
栄華	えいが	prosperity
手	て	hand, forepaw, handle, hand, trouble, means, hand, kind, one's hands, ability to cope, hand (of cards), direction, move (in go, shogi, etc.), Te, Hand
国家	こっか	state, State (polity)
カット	カット	cut, haircut, shuffle (cards), scene
本格	ほんかく	original method or procedure, serious
氷	こおり	ice, shaved ice (usually served with flavored simple syrup), Ice
船体	せんたい	hull, Hull (watercraft)
一定	いってい	fixed
頂点	ちょうてん	top, vertex, Vertex (geometry)
母	はは	mother
果たす	はたす	to accomplish, to do ... completely
動植物	どうしょくぶつ	plants and animals
社会	しゃかい	society, social studies, Society
矮小	わいしょう	diminutive, narrow (e.g. thinking)
時空	じくう	space-time, Spacetime
は	は	topic marker particle, indicates contrast with another option (stated or unstated), adds emphasis, Ha (kana)
リーガ	リーガー	leaguer (e.g. major leaguer)
朝	あさ	morning, breakfast, next morning, Morning
機会	きかい	chance
物	もの	thing, one's things, things, quality, reason, used to emphasize emotion, judgment, etc., item classified as ..., cause of ..., somehow, really
身	み	body, oneself, one's place, main part
リフト	リフト	lift, rift, Lift
ば	ば	place, field, occasion, scene (of a play, movie, etc.), session (of the stock market), field, round (east, south, etc.), field, field (gestalt psychology), Field (physics)
もの	もの	thing, one's things, things, quality, reason, used to emphasize emotion, judgment, etc., item classified as ..., cause of ..., somehow, really
いきよい	いきおい	force, influence, impetus, naturally
職業	しょくぎょう	occupation, Job (role)
失言	しつげん	verbal gaffe
具体	ぐたい	concrete
ヨーロッパれ	ヨーロッパれんごう	European Union
始め	はじめ	beginning, first (in line, etc.), origin, such as ...
合成	ごうせい	composition, composite, (function) composition, Synthesis
史	し	history
失笑	しっしょう	laughing at an inappropriate time, scornful laughter
包む	つつむ	to wrap up, to cover, to conceal (a feeling), to give (money in an envelope; as a wedding gift, funeral offering, etc.)
ふぇりう	ふ	negative
分子	ぶんし	numerator, molecule, member, Molecule
か	か	lesson, section (in an organization), counter for lessons and chapters (of a book)
切れ	きれ	piece, cloth, sharpness, agility, counter for scraps, pieces, etc.
機構	きこう	mechanism
交代	こうたい	alternation
作ら	さくがら	crop conditions, quality (of art)
細胞	さいぼう	cell, cell (in an organization, esp. a communist party), Cell (biology)
生き	いき	living, freshness, situation in which a group of stones cannot be captured because it contains two or more gaps (in go), stet, damned
世界	せかい	the world, sphere, world-renowned, realm governed by one Buddha, World
独自	どくじ	original, independent
質	しつ	quality, nature, logical quality
地球	ちきゅう	Earth, Earth
枯渇	こかつ	drying up, running out
繁殖	はんしょく	breeding
繁栄	はんえい	prosperity
宗教	しゅうきょう	religion, religious activity, Religion
基本	きほん	basics
粒子	りゅうし	particle
春	はる	spring, New Year, prime (of life), adolescence, sexuality, Spring (season)
酸	さん	acid, sourness, Acid
から	から	from (e.g. time, place, numerical quantity), from (originator), because, out of (constituent, part), through (e.g. window, vestibule), after, expresses sympathy or warning
競争	きょうそう	competition, competition (between organisms or species)
状態	じょうたい	state
呼ば	よばわり	denouncing
出さ	でぐちちょうさ	exit poll, Exit poll
基づい	もとづく	to be grounded on
多	た	multi-
潮汐	ちょうせき	tide, Tide
同位	どうい	the same rank
突入	とつにゅう	rushing into, plunging into (war, etc.)
切り開い	きりひらく	to cut open, to clear (land), to carve out (a new career, future, etc.)
システム	システム	system, System
進化	しんか	evolution, Evolution
復活	ふっかつ	revival (e.g. musical), restoration
面積	めんせき	square measure, Area
膜	まく	membrane
技巧	ぎこう	technique
要因	よういん	main cause
プラズマ	プラズマ	plasma, Plasma (physics)
プレート	プレート	plate (often as in "tectonic plate")
保障	ほしょう	guarantee, Co-signing
わたっ	わた	cotton plant (Gossypium spp.), batting
全滅	ぜんめつ	annihilation
その	その	that, part (as in "part two"), um ...
増加	ぞうか	increase
おり	おり	weave, Weaving
温度	おんど	temperature, Temperature
優位	ゆうい	predominance
認識	にんしき	recognition, Cognition
できる	できる	to be able (in a position) to do, to be ready, to be made, to be good at, to become intimate, to grow, to become pregnant
離合	りごう	alliance and rupture
徐々	じょじょ	slow, calm
都市	とし	town, City
だけ	だけ	only, as much as
アール	アール	R, radius, curve, nth year in the Reiwa era (May 1, 2019-), refrigerator
磁鉄	じてっこう	magnetite, Magnetite
エヌエー	ナン	not a number
獲得	かくとく	acquisition
電離	でんり	ionization, electrolytic dissociation
簡単	かんたん	simple, brief
中心	ちゅうしん	center, -centered, Centre (geometry)
エネルギー	エネルギー	energy, energy, energy source, food energy, Energy
立つ	たつ	to stand, to find oneself (e.g. in a difficult position), to depart (on a plane, train, etc.)
悪	あく	evil, (role of) the villain (in theatre, etc.), Evil
的	てき	-ical, -like, (something) like, -wise, Mr.
材料	ざいりょう	ingredients, material (for a novel, experiment, etc.), basis (for a decision), (market) factor
不可欠	ふかけつ	indispensable
始まる	はじまる	to begin, to happen (again), to date (from)
新酒	しんしゅ	new brew of sake
圧縮	あっしゅく	compression, Compression
症状	しょうじょう	symptoms
現象	げんしょう	phenomenon, Phenomenon
機関	きかん	engine, agency, system
容積	ようせき	capacity
書	ふみ	letter, Sentence (linguistics)
密接	みっせつ	close (relationship, connection, etc.), close (together)
突き進む	つきすすむ	to push on
動物	どうぶつ	animal, Animal
岩	いわ	rock, crag, anchor
氏	し	Mr, clan, he, counter for people
多種	たしゅ	many kinds
炉	ろ	hearth, furnace, Furnace
たゆみ	たゆみ	relaxing
拍車	はくしゃ	(riding) spur, Spur
打撃	だげき	blow, batting
跳ん	はねマン	win worth 12000 points (or, if dealer, 18000 points)
いる	いる	to be (of animate objects), to stay, to be ...-ing
嘲笑	ちょうしょう	scornful laughter
学	がく	learning, study of ...
紫外	しがい	ultraviolet
止め	とめ	(a) stop (e.g. in a timber joint, or at the end of a kanji stroke), remaining (e.g. poste-restante), forty-five degree angle
補佐	ほさ	aid
人間	にんげん	human being, character (of a person), Human
歴史	れきし	history, History
過去	かこ	the past, one's past (that one would prefer remained secret), past (tense), previous life, Past
戻る	もどる	to turn back (e.g. half-way), to return, to recover (e.g. something lost), to rebound
現す	あらわす	to represent, to reveal, to express, to make widely known
違う	ちがう	to differ (from), to not be in the usual condition, to not match the correct (answer, etc.), to be different from promised, isn't it?
マグマ	マグマ	magma, Magma
極	きょく	pole, climax
溶かし	とかす	to dissolve, to melt
表面	ひょうめん	surface, outside, appearances
大進	だいしんぽ	major progress
なか	なか	relation
難民	なんみん	refugee, person inconvenienced by (lack of something), Refugee
流れ	ながれ	flow (of a fluid or gas), flow (of people, things), course (of events), group of people who remain together after the end of an event, descent, forfeiture, cancellation, drifting, Flow
はるか	はるか	far away, long ago
入ら	はいる	to enter, to break into, to join, to contain, to have (an income of), to get turned on, to get
脂肪	しぼう	fat, Fat
大き	おおき	great, greater (of equal court ranks), a great deal
抜い	ばっすい	extract
型	かた	model, type, mold (mould), kata (standard form of a movement, posture, etc. in martial arts, sport, etc.), form (i.e. customary procedure), size (i.e. clothing, shoes), inch (in diagonal display size), (taxonomical) form, Type
過熱	かねつ	superheating
数千	すうせん	thousands
コンピュータ	コンピュータ	computer, Computer
真っ先	まっさき	the head
敵将	てきしょう	enemy general
られ	られつ	enumeration
製麺	せいめん	noodle making
ドラマ	ドラマ	(non-documentary) television series, drama, Dhrama (Greece), Drama
地域	ちいき	area, Region
激変	げきへん	sudden change
大型	おおがた	large
地上	ちじょう	above ground, this world
後	うしろ	back
ほど	ほど	extent, limit, (span of) time, (a) distance, the state of, about, as much as ..., the more ... the more ...
アフリカ	アフリカ	Africa
形態	けいたい	form, Shape
取り込む	とりこむ	to take in, to capture (e.g. image), to win over, to defraud of, to be busy
おい	おい	old age
など	など	et cetera, or something, the likes of, for example
切り替え	きりかえ	exchange
原書	げんしょ	original document (not a copy or adaptation)
交換	こうかん	exchange
他	ほか	other (place, thing, person), outside, nothing except, besides...
する	する	to do, to cause to become, to serve as, to wear (clothes, a facial expression, etc.), to judge as being, to decide on, to be sensed (of a smell, noise, etc.), to be (in a state, condition, etc.), to be worth, to pass (of time), to place, or raise, person A to a post or status B, to transform A to B, to make use of A for B, to feel A about B, verbalizing suffix (applies to nouns noted in this dictionary with the part of speech "vs"), creates a humble verb (after a noun prefixed with "o" or "go"), to be just about to
事象	じしょう	event
近代	きんだい	present day, early modern period (in Japan, usu. from the Meiji Restoration until the end of World War II)
中央	ちゅうおう	centre, metropolis, Chuuou
行政	ぎょうせい	administration, Executive (government)
あの	あの	that
細菌	さいきん	bacterium
サイズ	サイズ	size, Size
還元	かんげん	restoration, reduction
生態	せいたい	mode of life, (animal) territory
演武	えんぶ	martial arts demonstration, martial arts training, Embusen
警察	けいさつ	police, police officer, police station, Police
さらさ	サラサ	cotton print, Chintz
たび	たび	travel
哺乳	ほにゅう	suckling
育む	はぐくむ	to raise, to cultivate
気象	きしょう	weather, disposition, Weather
星間	せいかん	interstellar
果たし	はたして	as was expected, really
待機	たいき	standing by
れ	レ	check mark
食糧	しょくりょう	food (esp. staple food such as rice or wheat)
作る	つくる	to make, to prepare (food), to raise, to till, to draw up (a document), to create (an artistic work, etc.), to coin (a phrase), to have (a child), to make up (one's face, etc.), to fabricate (an excuse, etc.), to give a (false) appearance, to form (a line, etc.), to set (a record), to commit (a sin, etc.)
発展	はってん	development, development (of a situation, story, etc.), playing around, Hatten
高	たか	quantity
大	だい	large, great, -sized, university, large (e.g. serving size), long month (i.e. having 31 days)
陸上	りくじょう	(on) land, track-and-field events
発生	はっせい	outbreak, generation (e.g. of power or heat), ontogeny
角膜	かくまく	cornea, Cornea
質的	しつてき	qualitative
生み出さ	うみだす	to create, to invent, to give birth to
取り	とり	taking, last performer of the day (usu. the star performer), active partner (e.g. in judo demonstration), emphatic or formal prefix
地殻	ちかく	(Earth's) crust, Crust (geology)
知見	ちけん	expertise
実現	じつげん	implementation (e.g. of a system)
農業	のうぎょう	agriculture, Agriculture
姿	すがた	figure, appearance, state, form (of a waka), dressed in ...
生息	せいそく	inhabiting
一瞬	いっしゅん	instant
牧畜	ぼくちく	stock-farming, Pastoralism
仕組み	しくみ	structure, plan
より	より	than, from, except, more, Yori (kana)
爆発	ばくはつ	explosion, eruption (of discontent, etc.), Explosion
同士	どうし	fellow
大地	だいち	ground
再三	さいさん	again and again
開始	かいし	start
部分	ぶぶん	portion
イクチオステガ	イクチオステガ	Ichthyostega
紙	かみ	paper, Paper
世襲	せしゅう	heredity, Order of succession
現れ	あらわれ	embodiment
生じ	しょうじる	to produce, to result from
つながる	つながる	to be tied together, to lead to, to be related (by blood)
軌道	きどう	orbit, railroad track, (right) track
イオン	イオン	ion, Ion
渡っ	わたる	to cross over, to extend
低音	ていおん	low tone
深刻	しんこく	serious
集散	しゅうさん	collection (gathering) and distribution
ステージ	ステージ	stage, performance, Stage
何	なに	what, you-know-what, whatsit, (not) at all, what?, hey!, oh, no (it's fine)
骨格	こっかく	skeleton, framework, Skeleton
主役	しゅやく	leading part
文化	ぶんか	culture, Bunka era (1804.2.11-1818.4.22), Bunka, Culture
電流	でんりゅう	electric current, Electric current
日	にち	Sunday, day (of the month), counter for days, Japan, Nichi
葉緑	ようりょくたい	chloroplast, Chloroplast
場所	ばしょ	place, room, basho
逆	ぎゃく	reverse, converse (of a hypothesis, etc.), inverse (function), Converse (logic)
支配	しはい	domination, direction, control (e.g. over one's emotions)
族	ぞく	tribe, (taxonomical) tribe, group (of the periodic table)
近づく	ちかづく	to approach, to get acquainted with
薄い	うすい	thin, pale, watery, weak (taste, etc.), slim (probability, etc.), sparse
循環	じゅんかん	circulation
ブーン	ブーン	whirr, whoosh, Boone
へ	へ	to, He (kana)
施工	せこう	construction
摂取	せっしゅ	intake (e.g. of salt), absorption (e.g. of new knowledge), reception and protection, Ingestion
侵食	しんしょく	encroachment, erosion, Erosion
とも	とも	friend, accompaniment
まだ	まだ	still, (not) yet, more, at least, unfinished
実	じつ	truth, sincerity, content, (good) result
おら	おら	I
行わ	おこなわれる	to be done
受粉	じゅふん	pollination, Pollination
減少	げんしょう	decrease
惨劇	さんげき	tragedy
占める	しめる	to occupy, to account for
湖水	こすい	lake
サイクル	サイクル	cycle, Cycle
停止	ていし	stoppage, ceasing (movement, activity, etc.), suspension (of payment, licence, etc.), suspension of music, dance, etc. as a sign of mourning for a prominent person
テクトニクス	テクトニクス	tectonics, Tectonics
選挙	せんきょ	election, Election
はじめ	はじめ	beginning, first (in line, etc.), origin, such as ...
消費	しょうひ	consumption, Consumption (economics)
ますます	ますます	increasingly
異	い	difference (of opinion), strange, different
柱	はしら	pillar, support, counter for buddhas, gods, nobles, etc., Column
向かい	むかい	facing
南端	なんたん	southern tip
星々	ほしぼし	stars
ニュートン	ニュートン	newton (N) (SI unit of force), Newton (Sir Isaac), Newton (unit)
含ま	ふくませる	to soak
バリエーション	バリエーション	variation, Variation
出発	しゅっぱつ	departure
藻類	そうるい	seaweed, Algae
場	ば	place, field, occasion, scene (of a play, movie, etc.), session (of the stock market), field, round (east, south, etc.), field, field (gestalt psychology), Field (physics)
ミト	ミトコンドリア	mitochondria, Mitochondrion
始まろう	はじまる	to begin, to happen (again), to date (from)
さらに	さらに	furthermore
かけら	かけら	fragment, ounce (of truth, conscience, etc.)
地中	ちちゅう	underground
大西	たいせいよう	Atlantic Ocean, Taiseiyou, Atlantic Ocean
ら	ら	pluralizing suffix, or so, nominalizing suffix
豪州	ごうしゅう	Australia
形	かたち	form, visage
鉄道	てつどう	railroad, Rail transport
真正	しんせい	genuine
いん	いん	member
日陰	ひかげ	shade, sunshine
文明	ぶんめい	civilization, Bunmei era (1469.4.28-1487.7.20), Civilization
さ	さ	difference, difference
組織	そしき	organization, structure, system (e.g. railroad, transport, party, etc.), tissue, texture (of a rock), weave (of a fabric)
大陸	たいりく	continent, continental Asia (esp. mainland China), continental Europe, Continent
合い	あい	between-season wear, together, condition, -ish
大気	たいき	atmosphere, magnanimity
よ	よ	world, life, age, reign, the times, world (of existence), Series (stratigraphy)
大切	たいせつ	important, beloved, careful
月面	げつめん	moon's surface
元素	げんそ	element, (classical) element (e.g. earth, water, air, fire), origin, Chemical element
法	ほう	law, method, mood, dharma
離れ	はなれ	detached building, separation from
太鼓	たいこ	drum, Drum
終焉	しゅうえん	demise
結びつき	むすびつき	connection
初期	しょき	early (days), initial
絶滅	ぜつめつ	extinction, eradication, Extinction
空間	くうかん	space, Space
生き物	いきもの	living thing
利用	りよう	use
進ん	すすんで	voluntarily
予測	よそく	prediction
当時	とうじ	at that time, Touji
一時	いちじ	one o'clock, once, for a time, a time
終わり	おわり	the end
しまう	しまう	to finish, to close (a business, etc.), to put away, to do completely, to do accidentally
産	さん	(giving) birth, native of, assets
歩み	あゆみ	walking, pace, course (of history, one's life, etc.), pitch (of a screw, etc.)
起こら	おこる	to occur
出現	しゅつげん	appearance
起こっ	おこる	to occur
大会	たいかい	mass meeting, tournament, grand event
近い	ちかい	near, close (in time), close (relationship), closely related, similar
さん	さん	three, tri-
でき	でき	workmanship, grades, quality (e.g. of a crop), dealings
こと	こと	thing, incident, circumstances, work, after an inflectable word, creates a noun phrase indicating something the speaker does not feel close to, nominalizing suffix, pretending to ..., alias, necessity, you should ...
範囲	はんい	extent
様々	さまざま	various
代謝	たいしゃ	metabolism, renewal, Metabolism
迎える	むかえる	to go out to meet, to receive, to accept (e.g. as a member of a group or family), to call for, to approach (a certain time, a point in one's life, etc.)
断続	だんぞく	intermittence
嫌気	いやき	dislike
公達	きんだち	kings
暖かい	あたたかい	warm, considerate, warm (of a colour), having enough money
炭素	たんそ	carbon (C), Carbon
海嶺	かいれい	(submarine) ridge, Mid-ocean ridge
イギリス	イギリス	United Kingdom, England
戦争	せんそう	war, fighting, War
鉄	てつ	iron (Fe), strong and hard (as iron), railway, railway enthusiast, Iron
室	しつ	room, wife (of someone of high rank), scabbard, Chinese "Encampment" constellation (one of the 28 mansions)
いよいよ	いよいよ	more and more, at last, (at the) last moment
初めて	はじめて	for the first time, only after ... is it ..., first time
到達	とうたつ	reaching
増やす	ふやす	to increase
太平	たいへい	peace, happy-go-lucky, Taiping
運ば	うんどうじょう	sports ground, Undoujou, Playing field
削り取ら	けずりとる	to shave off
声明	せいめい	declaration, Shōmyō
降り注ぐ	ふりそそぐ	to rain incessantly
使える	つかえる	to be usable
ジア	ジアゾジニトロフェノール	diazodinitrophenol, Diazodinitrophenol
湖	みずうみ	lake, Lake
コア	コア	core, core, Core
一方	いっぽう	one (esp. of two), on the one hand, whereas, just keeps, Ippou
四	し	four
脳	のう	brain, brains, Brain
最も	もっとも	most
価鉄	あたい	price, value, value, Value
が	が	indicates sentence subject (occasionally object), indicates possessive (esp. in literary expressions), but, regardless of
急速	きゅうそく	rapid (e.g. progress)
小国	しょうこく	small country
ん	ん	yes, huh?, not, 's, at (place, time), N (kana)
分布	ぶんぷ	distribution, Distribution
武器	ぶき	weapon, weapon (something used to gain an advantage), Weapon
達する	たっする	to reach
地表	ちひょう	surface of the earth
魚類	ぎょるい	fish, Fish
規模	きぼ	scale
生まれ	うまれ	birth, born in (country, month, imperial era, zodiac year, etc.)
孤立	こりつ	isolation
適合	てきごう	conformity
恵まれ	めぐまれる	to be blessed with
界	さかい	border, turning point, area, psychological state, cognitive object
含ん	ふくみしさん	hidden assets
アジア	アジア	Asia, Asia
始める	はじめる	to start, to start up (a business, society, etc.), to start ...
南	みなみ	south, South
台	だい	stand, support, counter for machines, incl. vehicles, setting (e.g. in jewellery), level (e.g. price level), elevated area, viewing platform, dish tray, meal, tall building
矮	わいしょう	diminutive, narrow (e.g. thinking)
発熱	はつねつ	generation of heat, (attack of) fever, Fever
一	いち	one, best, first, beginning, a (single), ace (playing card), bottom string (on a shamisen, etc.)
ロリス	ロリス	loris, Lorris
突然	とつぜん	abrupt
崩壊	ほうかい	collapse, (radioactive) decay
起こる	おこる	to occur
境	さかい	border, turning point, area, psychological state, cognitive object
スターバースト	スターバースト	Starburst region
岩石	がんせき	rock, Rock (geology)
法律	ほうりつ	law, Statute
脂質	ししつ	lipid, Lipid
豊か	ゆたか	abundant, rich, open (mind), plump (e.g. breasts), (well) over
含む	ふくむ	to contain, to hold in the mouth, to bear in mind, to express (emotion, etc.)
前回	ぜんかい	previous time
樹	き	tree, wood, Tree
位	くらい	throne, government position, social standing, grade (of quality, etc.), position of a figure (e.g. tens, thousands), degree
黒星	くろぼし	black spot, mark indicating a defeat, loss
耐える	たえる	to bear, to support, to be fit for
探査	たんさ	probe
増大	ぞうだい	enlargement
短い	みじかい	short, brief
そこ	そこ	there (place relatively near listener), there (place just mentioned), then (of some incident just spoken of), you
たくさん	たくさん	a lot, enough, enough
たし	たし	bearing many children, Oigo
海王	かいおうせい	Neptune (planet), Neptune
つながり	つながり	connection
十分	じゅうぶん	enough, sufficiently, division into ten
イボ	いぼ	wart
よう	よう	appearing ..., way to ..., form, like, thing (thought or spoken)
形成	けいせい	formation, repair (e.g. plastic surgery)
向かっ	むかっぱら	anger
原核	げんかくせいぶつ	prokaryote, Prokaryote
頻度	ひんど	frequency (of occurrence)
目前	もくぜん	before one's very eyes
とっん	とぶ	to fly, to jump, to spatter, to hurry, to flee, to disappear, to break off, to be sent out (of an order), to come flying (of a punch, kick, etc.), to be missing (of a page, stitch, etc.)
な	な	don't, do, hey, now, ..., wow, Na (kana)
浄化	じょうか	purification, cleanup (e.g. of politics)
統一	とういつ	unity, Political union
機能	きのう	function
なり	なり	or something, ... or ..., as soon as, while still
クレーター	クレーター	crater, pockmark, Impact crater
知ら	しらせる	to notify
中和	ちゅうわ	neutralization
再度	さいど	twice
生きる	いきる	to live, to make a living, to be in effect, to come to life, to be safe (in baseball, go, etc.), To Live (film)
拡大	かくだい	magnification
生活	せいかつ	living, Seikatsu
よく	よく	nicely, frequently, I'm glad that you ..., (you have) quite the nerve to
主義	しゅぎ	doctrine
なる	なる	to become, to result in, to consist of, to be completed, to change (into), to come (to do), to come to, to play (the part of), to be used for, to be promoted, to do ..., Naru
全体	ぜんたい	whole
死滅	しめつ	extinction
マントル	マントル	mantle, mantle (e.g. gas), Mantle (geology)
万	まん	10,000, myriad, everything, various
よっ	よっつ	four, four years of age, ten o'clock (old time system), cross grips
反映	はんえい	reflection (light, image, situation, attitude, etc.), influence
沈ん	しずんだこころ	low spirits
剛性	ごうせい	hardness, Stiffness
危機	きき	crisis, Close to the Edge (Yes album)
機	き	chance, machine, aircraft, counter for aircraft, counter for remaining lives (in video games)
念	ねん	sense, desire, attention
オゾン	オゾン	ozone, Ozone
出会う	であう	to meet (by chance), to meet (e.g. of rivers, highways, etc.), to emerge and engage (an enemy)
挙げ	あげる	to raise, to do up (one's hair), to fly (a kite, etc.), to land (a boat), to deep-fry, to show someone (into a room), to give, to send someone (away), to enrol (one's child in school), to increase (price, quality, status, etc.), to make (a loud sound), to earn (something desirable), to praise, to give (an example, etc.), to summon up (all of one's energy, etc.), to arrest, to nominate, to summon (for geishas, etc.), to offer up (incense, a prayer, etc.) to the gods (or Buddha, etc.), to bear (a child), to conduct (a ceremony, esp. a wedding), (of the tide) to come in, to vomit, to do for (the sake of someone else), to complete ..., to humbly do ..., Deep frying
倍	ばい	double, times (as much), 1-nth
音そう	おんせいたじゅうほうそう	multiplex broadcast or transmission, Second audio program
新星	しんせい	nova, new face, Nova
選ぶ	えらぶ	to choose
以来	いらい	since
水漏れ	みずもれ	(water) leak
整っ	ととのった	well-ordered
守ら	まもる	to protect, to keep (i.e. a promise)
バリア	バリア	barrier, obstacle, imaginary shield that gives one invincibility or immunity, Barrier
請け負う	うけおう	to contract, to take over
アポロ	アポロ	Apollo program, Apollo (Greek and Roman god)
火星	かせい	Mars (planet), Mars
出来上がっ	できあがる	to be completed, to be very drunk
自然	しぜん	nature, natural, naturally, Nature
私	わたし	I
起き	おきる	to get up, to wake up, to occur (usu. of unfavourable incidents)
押し上げ	おしあげ	upheaval
消える	きえる	to go out
レベル	レベル	level, level (plane), spirit level, minor release sequence number (software versioning), rebel
富ん	ふじさん	Mount Fuji, Fujisan, Mount Fuji
創造	そうぞう	creation
増し	まし	better, more, increase
肺	はい	lung, Lung
注い	ちゅうい	attention, care, advice, Attention
体協	たいきょう	Japan Amateur Sports Association
金属	きんぞく	metal, Kinzoku, Metal
も	も	too, both A and B, even, even if, further, Mo (kana)
地盤	じばん	ground, foundation (building, etc.), constituency
深部	しんぶ	depths
ここ	ここ	individual
作り出す	つくりだす	to manufacture, to invent
今	いま	now, another
借り	かり	borrowing
近く	ちかく	near, nearly (e.g. "it took nearly one year"), shortly
雨	あめ	rain, rainy day, the November suit (in hanafuda), Rain
体長	たいちょう	length (of an animal)
溶け出す	とけだす	to begin to dissolve
維持	いじ	maintenance
恐竜	きょうりゅう	dinosaur, Dinosaur
ファイアーる	ファイア	fire
直接	ちょくせつ	direct
ゴンドワナ	ゴンドワナ	Gondwana, Gondwana (India)
タンパク	たんぱく	protein, egg white
輸送	ゆそう	transport
構想	こうそう	plan
北米	ほくべい	North America, Hokubei
自己	じこ	self, Psychology of self
不安	ふあん	anxiety, Anxiety
ある	ある	to be, to have, to be located, to be equipped with, to happen
低い	ひくい	low (rank, degree, value, content, quality, etc.), low (position), short (height), deep (voice)
そして	そして	and
巻き込ま	まきこむ	to roll up, to involve
連続	れんぞく	continuation
飛躍	ひやく	leaping, leapfrog (over a problem), making great strides, emerging, becoming active
単位	たんい	unit, credit (in school), in units of (e.g. "in thousands"), Unit
達し	たっし	official notice
鈴	すず	bell (often globular)
表層	ひょうそう	surface
成分	せいぶん	ingredient
胸	むね	chest, breasts, heart, lungs, stomach, heart, Chest
補い	おぎない	replenishment
カルシウム	カルシウム	calcium (Ca), Karushiumu, Calcium
冷え	ひえ	chilliness
類	るい	kind, similar example
使う	つかう	to use (a thing, method, etc.), to use (a person, animal, puppet, etc.), to use (time, money, etc.), to use (language)
雲	くも	cloud, Cloud
パターン	パターン	pattern, behavioural pattern, Patan (Nepal), Pattern
保持	ほじ	retention
オーバーターン	オーバー	overcoat, exceeding, exaggerated, over par, overexposure, Oba (Canada), Over
起こし	おこし	development, standing (something) up, waking up, tilling a rice field, drawing a card from the draw pile
青色	あおいろ	blue
パンゲア	パンゲア	Pangaea
花柄	はながら	flower pattern
特に	とくに	particularly
下部	かぶ	lower part, subordinate (office)
アンドロメダ	アンドロメダ	Andromeda
おけ	おけ	bucket
活発	かっぱつ	lively
持ち上げ	もちあげる	to elevate, to flatter
しかし	しかし	however
融合	ゆうごう	agglutination
超える	こえる	to cross over, to exceed
法則	ほうそく	law
隕石	いんせき	meteorite, Meteorite
混じり合い	まじる	to be mixed, to associate with
蓄積	ちくせき	accumulation
周辺	しゅうへん	circumference, (computer) peripheral
変動	へんどう	change
結びつい	むすびつく	to be related, to result in
流れ込ん	ながれこむ	to flow into
取り込み	とりこみ	taking in, capturing (e.g. customers), confusion, importing (e.g. data)
期	き	period, opportunity, age, term (e.g. in office), session (e.g. of parliament), stage (e.g. of a disease), season (e.g. of a TV series)
飛行	ひこう	aviation, to fly
層	そう	layer, class, sheaf, counter for stories (of a building)
原子	げんし	atom, Atom
なかっ	なかったことにする	to forget something ever existed
制	せい	system
大量	たいりょう	large quantity
窒素	ちっそ	nitrogen (N), Nitrogen
わずか	わずか	(a) little, only
河川	かせん	rivers
浅瀬	あさせ	shoal
溜まっ	たまる	to collect
生き抜い	いきぬく	to live through
古い	ふるい	old, long, of the distant past, stale, old-fashioned
人口	じんこう	population, common talk, Population
近づい	ちかづく	to approach, to get acquainted with
濃度	のうど	concentration, cardinality, Concentration
塩	しお	salt, hardship, saltiness, cold, Salt
茎	くき	stalk, Plant stem
風化	ふうか	weathering, fading (of memories), efflorescence, Weathering
科学	かがく	science, Science
全球	ぜんきゅうちきゅうかんそくシステム	Global Earth Observation System of Systems, Global Earth Observation System of Systems
ごろ	ころ	(approximate) time, suitable time (or condition), time of year
市場	いちば	(town) market, Market
潤滑	じゅんかつ	lubrication, Lubrication
存在	そんざい	existence, Existence
いえる	いえる	to be possible to say, said
ショー	ショー	show, She
条件	じょうけん	condition
準備	じゅんび	preparation
鎧	よろい	armor, Yoroi
有害	ゆうがい	harmful
入れ	いれ	container, inserting
なぜ	なぜ	why
古細菌	こさいきん	archaea, Archaea
受け	うけ	popularity, defense, agreement, receiver of technique (e.g. in martial arts), submissive partner of a homosexual relationship
ず	ず	drawing, sight
海底	かいてい	bottom of the ocean, undersea, Seabed
閉鎖	へいさ	closing
人々	ひとびと	people, each person
先延ばし	さきのばし	delay, Procrastination
を	を	indicates direct object of action, indicates subject of causative expression, indicates an area traversed, indicates time (period) over which action takes place, indicates point of departure or separation of action, indicates object of desire, like, hate, etc., Wo (kana)
行く	いく	to go, to proceed, to pass through, to walk, to die, to do (in a specific way), to stream, to continue, to have an orgasm, to trip
幕内	まくうち	highest-ranking division, Makuuchi
見え	みえ	airs
比べれ	くらべる	to compare, to compete
外部	がいぶ	outside (e.g. of a building), outside (of a group, company, etc.)
可能	かのう	possible
配列	はいれつ	arrangement, array (programming), Array data structure
湿地	しっち	damp ground, Wetland
続く	つづく	to continue, to continue (without a break), to occur again and again, to lead to, to come after, to hold out
プリンキピア	プリンキピア	Philosophiae Naturalis Principia Mathematica (physical science treatise by Sir Isaac Newton, 1687)
境界	きょうかい	boundary
玄武岩	げんぶがん	basalt, Basalt
過	か	surplus-, per- (chemical with more of a certain element than found in other compounds of the same constituents)
加速	かそく	acceleration
近かっ	ちかい	near, close (in time), close (relationship), closely related, similar
釣果	ちょうか	catch (fishing)
来	らい	next (year, spring, etc.), since (last month, etc.)
ワイン	ワイン	wine, Wine
広がっ	ひろがる	to spread (out)
捕手	ほしゅ	catcher, Catcher
周囲	しゅうい	surroundings, circumference
間	あいだ	space (between), period of time (during, while), between (two parties or things), among (a group), relations (between), midpoint, due to, Ma (negative space)
大きい	おおきい	big, loud, extensive, important, older
深い	ふかい	deep, profound, dense, close (relationship), intense, late
よる	よる	evening, dinner, Night
やがて	やがて	before long, almost, finally
約	やく	approximately, promise, shortening, contraction (in phonetics)
新種	しんしゅ	new species
ガー	ガー	(but) what about (the) ...
酸素	さんそ	oxygen (O), Oxygen
衝突	しょうとつ	collision, conflict, Collision
増え	ふえる	to increase
管弦	かんげん	wind and string instruments
種	たね	seed (e.g. of a plant), material (e.g. for an article), ingredient, cause, trick, paternal blood, breed (of a stock), 10-point card (in hanafuda)
うち	うち	inside, while (e.g. one is young), among, in (secret, chaos, poverty, etc.), within oneself, we, one's home, my spouse, signed on behalf of (husband's name) by his wife, I, imperial palace grounds, emperor
大きな	おおきな	big
充実	じゅうじつ	fullness, enhancement, replenishment
繰り返さ	くりかえす	to repeat
両生	りょうせい	amphibious
石炭	せきたん	coal, Coal
数え	かぞえ	East Asian age reckoning
経済	けいざい	economy, finance, being economical, Economy
対流	たいりゅう	convection, Convection
冷却	れいきゃく	cooling, Refrigeration
あらゆる	あらゆる	all
地下	ちか	underground, world of the dead, underground (activities, movement, etc.), Subterranea (geography)
ハイ	ハイ	high (e.g. spirits), high, high (i.e. feeling of extreme pleasure), Al-Hayy (Iraq)
成長	せいちょう	growth, growth (of a company, the economy, etc.)
伴う	ともなう	to accompany, to be accompanied by
持ち主	もちぬし	owner
寒冷	かんれい	cold
と	と	door (esp. Japanese-style), shutter, entrance (to a home), narrows, To, Gate
原始	げんし	origin, primeval
共生	きょうせい	coexistence, symbiosis, paragenesis, Symbiosis
待っ	まった	false start of a bout, backsies (called when taking back a move in a game), wait!
げっ歯	げっしどうぶつ	gnawing animal, rodent
次元	じげん	dimension, perspective, Dimension
役割	やくわり	part, Role
館	かん	house
これ	これ	this, this person, now, here, used to stress the subject of a sentence, I
キロメートル	キロメートル	kilometer
重要	じゅうよう	important
栄養	えいよう	nutrition, Nutrition
猿	さる	monkey (esp. the Japanese macaque, Macaca fuscata), sly person, idiot, sliding wooden bolt (for holding a door or window shut), clasp used to control the height of a pot-hook, bathhouse prostitute, Sarh (Chad), Monkey
降り注い	ふりそそぐ	to rain incessantly
脊椎	せきつい	spine, Vertebral column
タイミング	タイミング	timing, Timing
発明	はつめい	invention, intelligent, making sense (of something), Invention
生物	せいぶつ	living thing, biology, Organism
次々	つぎつぎ	in succession
備え	そなえ	preparation
産ん	さん	(giving) birth, native of, assets
激しい	はげしい	violent, extreme, fervent, incessant, precipitous
つれ	つれ	companion, tritagonist
貧	ひん	poverty, insufficiency
元	もと	origin, base, cause, ingredient, (somebody's) side, original cost (or capital, principal, etc.), (plant) root, first section of a waka, counter for blades of grass, tree trunks, etc., and for falcons (in falconry), handle (chopsticks, brush, etc.), Book
飲み込ま	のみこむ	to gulp down, to understand, to engulf, to be filled with (people), to hold back from saying something
記憶	きおく	memory, storage, Memory
欠点	けってん	fault, failure (in an examination)
しれ	しれい	orders
リク	レクリエーション	recreation, re-creation
外側	そとがわ	exterior, Sotogawa
種類	しゅるい	variety, counter for kinds, species, etc.
市	し	city
環境	かんきょう	environment
猛毒	もうどく	deadly poison
襲っ	おそう	to attack, to succeed (someone in a post, role, etc.), to make a sudden visit
進み	すすみ	progress
量	りょう	quantity, generosity, pramana, Quantity
ホーク	フォーク	fork, forkball
再び	ふたたび	again
あ	あ	sub-, -ous (indicating a low oxidation state), Asia, Argentina, Arabia, America
放射	ほうしゃ	radiation, Radiation
系統	けいとう	system, lineage, group (e.g. of colors) (colours), close (evolutionary) relationship, a population sharing a common ancestor (in genetics)
覆わ	おおわれ	cover (e.g. of snow, trees, etc.)
巨大	きょだい	huge
複製	ふくせい	reproduction
分	ぶん	part, amount, one's means, one's duty, condition, in proportion to, content (e.g. alcohol), equivalent to (e.g. an old brother)
数十	すうじゅう	dozens
水素	すいそ	hydrogen (H), Hydrogen
双	そう	pair
で	で	coming out, attending (work), start, origins, architectural member that projects outward, highest point of the stern of a ship, amount (comprising something)
視野	しや	field of vision, one's outlook (e.g. on life), Field of view
超え	こえる	to cross over, to exceed
まで	まで	until (a time), to (a place), to (an extent), only
赤道	せきどう	equator, Equator
構築	こうちく	construction
装置	そうち	equipment, stage setting
守る	まもる	to protect, to keep (i.e. a promise)
もともと	もともと	originally
招待	しょうたい	invitation
軍	ぐん	army, military authorities, team
鉱床	こうしょう	mineral deposit, Deposition (geology)
率	りつ	rate
夜行	やこう	walking around at night, night train
財務	ざいむ	financial affairs
以上	いじょう	not less than, beyond (e.g. one's expectations), above-mentioned, since ..., that's all
回	かい	counter for occurrences, a time, inning (baseball), episode, Hui (people), Islam
鉱	あらがね	ore
分岐	ぶんき	divergence, Bunki
の	の	indicates possessive, nominalizes verbs and adjectives, substitutes for "ga" in subordinate phrases, (at sentence-end, falling tone) indicates a confident conclusion, (at sentence-end) indicates emotional emphasis, (at sentence-end, rising tone) indicates question, No (kana)
互い	たがい	each other
対応	たいおう	correspondence (to), suitability, dealing with, compatibility (with technology, software, etc.)
貢献	こうけん	contribution (furthering a goal or cause)
彼	かれ	he, boyfriend
民主	みんしゅ	democracy, Democratic Party (esp. DPJ)
比べ	くらべ	contest
不足	ふそく	insufficiency, dissatisfaction
頻繁	ひんぱん	frequent
生き残る	いきのこる	to survive
表	おもて	surface, face (i.e. the visible side of an object), front (of a building, etc.), outside, appearance, public, first half (of an inning), cover (for tatami mats, etc.), foreground
遺伝	いでん	heredity, Heredity
一掃	いっそう	clean sweep
冠進	かんむり	traditional cap worn by Shinto clergy and courtiers, crown, top kanji radical, first verse of a haikai, etc., best, name, Crown (headgear)
磁場	じば	magnetic field, ambience, Magnetic field
しか	しか	deer (esp. the sika deer, Cervus nippon), Deer
生成	せいせい	creation
包ま	くるまる	to be wrapped up (e.g. in a blanket)
引き起こし	ひきおこす	to cause, to pull upright
二	に	two
濁	にごる	to become muddy, to become dull (of a sound, color, etc.), to become impure (of a heart, society, etc.), to become voiced
ウラン	ウラン	uranium (U), Oullins (France), Uranium
詰まっ	つむ	to become fine (of fabric), to be checkmated, to be hard pressed
インターネット	インターネット	Internet, Internet
高い	たかい	high, expensive, high (level), loud, high-pitched
酵素	こうそ	enzyme, Enzyme
およそ	およそ	about, generally, completely, outline
北側	きたがわ	north side
エリア	エリア	area, Elijah
陸地	りくち	land
促す	うながす	to urge, to stimulate (e.g. growth)
酸化	さんか	oxidation
弱まっ	よわまる	to abate
秩序	ちつじょ	order
のみ	のみ	only
部	ぶ	department (in an organization), club, part, category, counter for copies of a newspaper or magazine
紀	き	period, Nihon-shoki, System (stratigraphy)
下位	かい	low rank
たち	たち	pluralizing suffix (esp. for people and animals; formerly honorific)
受ける	うける	to receive, to catch (e.g. a ball), to be struck by (wind, waves, sunlight, etc.), to sustain (damage), to undergo (e.g. surgery), to be given (e.g. life, talent), to find funny, to follow, to face (south, etc.), to be modified by, to obtain (a pawned item, etc.) by paying a fee, to be well-received
反応	はんのう	reaction, Reaction
日惑星	にち	Sunday, day (of the month), counter for days, Japan, Nichi
取り返し	とりかえし	recovery
代	よ	world, life, age, reign, the times, world (of existence), Series (stratigraphy)
集まっ	あつまる	to gather
っ	って	you said, if ... then, do you seriously think that, I already told you, the said ..., says that ..., I hear that ..., as for the term ..., as for ..., Te (kana)
ガス	ガス	gas (state of matter, e.g. poison gas, natural gas), gasoline, dense fog, gas stove, flatulence
伝え	つたえ	legend
組み合わせ	くみあわせ	combination, matching (in a contest), combination
分断	ぶんだん	dividing into parts
水中	すいちゅう	underwater
双極子	そうきょくし	dipole, Dipole
蓄え	たくわえ	store
密度	みつど	density, Density
埋没	まいぼつ	being buried, remaining unknown, being absorbed (e.g. in research)
コンドリア	コン	Gong, Kon
第	だい	prefix for forming ordinal numbers
分け	わけ	sharing, draw
始まっ	はじまる	to begin, to happen (again), to date (from)
変化	へんか	change, variety, inflection, sidestepping
先	さき	point, head (of a line), first, (the way) ahead, future, previous, destination, rest (e.g. of a story), the other party
向かう	むかう	to face, to go towards
生き残っ	いきのこる	to survive
混じり合う	まじりあう	to be mixed together
それ	それ	that, then, there, you
ユカタン	ユカタンかいきょう	Yucatan Channel, Yucatán Channel
それぞれ	それぞれ	each
医学	いがく	medical science, Medicine
作り	つくり	making, appearance (attire, make-up, etc.), build, sashimi, forced (smile, etc.)
到来	とうらい	arrival
微	び	minuteness, one millionth
分かれ	わかれ	offshoot
助け	たすけ	assistance
南米	なんべい	South America, Nanbei
人	ひと	man, human being, human (Homo sapiens), character, man of talent, another person, adult
東	ひがし	east
生体	せいたい	organism
こそ	こそ	it is ... that ..., although, it is precisely because ... that ..., not at all
取り込ま	とりこむ	to take in, to capture (e.g. image), to win over, to defraud of, to be busy
結果	けっか	result, coming to fruition, as a result, Corollary
作っ	つくる	to make, to prepare (food), to raise, to till, to draw up (a document), to create (an artistic work, etc.), to coin (a phrase), to have (a child), to make up (one's face, etc.), to fabricate (an excuse, etc.), to give a (false) appearance, to form (a line, etc.), to set (a record), to commit (a sin, etc.)
新刊	しんかん	new book
リード	リード	lead, lead (of a newspaper, etc.), lead (wire), lead (e.g. dog), (sales) lead, reed (of a musical instrument), lied, read, Lead
生命	せいめい	life, (one's) working life, life force, Life
車	くるま	car, wheel
畳	たたみ	tatami mat
夜	よる	evening, dinner, Night
入っ	はいる	to enter, to break into, to join, to contain, to have (an income of), to get turned on, to get
生み	うみ	birth, creating
分裂	ぶんれつ	split, Fission (biology)
破壊	はかい	destruction, (application) crash, Subversion
活動	かつどう	activity (of a person, organization, animal, volcano, etc.), movie (esp. during the silent movie period)
汽	きしゃ	train (esp. long distance train), steam train
バレー	バレー	volleyball, valley, ballet, barré (chord in guitar technique)
横滑り	よこすべり	sideslip, shifting to another post (at the same level), sliding sideways down a slope (skiing)
巻く	まく	to wind, to envelope, to outflank, to link (verse), to move ahead (three hours, etc.)
迫っ	せまる	to approach, to press (someone for something)
下	した	below, bottom, beneath, just after, inferiority, trade-in, preliminary
集合	しゅうごう	meeting up, set, Set (mathematics)
生まれる	うまれる	to be born
川	かわ	river, River, Gawa, River
読ん	よんでじのごとく	literally
終わっ	おわる	to end
鉱物	こうぶつ	mineral, Mineral
閉じ込め	とじこめる	to lock up
中	ちゅう	medium, moderation, middle school, China, volume two (of three), during (a certain time when one did or is doing something), in
行っ	いってらっしゃい	have a good day
上	うえ	above, top, surface, before, superiority, on top of that, upon (further inspection, etc.), matters concerning ..., since (i.e. "for that reason"), honorable, place of one's superior (e.g. the throne), emperor, noblewoman (esp. the wife of a nobleman)
固まっ	かたまる	to harden, to become firm, to gather (together)
必然	ひつぜん	inevitable, inevitability
リーダー	リーダー	leader, reader, reader (i.e. someone who reads), microreader, dotted line (in printing)
会場	かいじょう	assembly hall
強	きょう	a little over, powerhouse
酸性	さんせい	acidity, acidic
旧	きゅう	old, the old, old times, Japan's old (lunisolar) calendar
促し	うながす	to urge, to stimulate (e.g. growth)
だろう	だろう	seems, don't you agree?
働き	はたらき	work, achievement, salary, action, conjugation
代表	だいひょう	representative, switchboard number
爬虫	はちゅう	reptile
緩和	かんわ	relief
上部	じょうぶ	top part
崩落	ほうらく	collapse
植物	しょくぶつ	plant, Plant
もたらし	もたらす	to bring
矯正	きょうせい	correction (of fault, defect, flaw, etc.), Corrections
電子	でんし	electron, electronic, Electron
氷河	ひょうが	glacier, Glacier
変遷	へんせん	change
一斉	いっせい	simultaneous
だっ	だっせん	derailment, digression
重力	じゅうりょく	gravity, Gravitation
試練	しれん	test
化石	かせき	fossil, petrifaction, Fossil
明治	めいじ	Meiji era (1868.9.8-1912.7.30), Meiji period
外国	がいこく	foreign country
引き起こす	ひきおこす	to cause, to pull upright
奪わ	うばう	to snatch away
影響	えいきょう	influence, to influence
三	さん	three, tri-
価	あたい	price, value, value, Value
年	とし	year, age, past one's prime, Year
空前	くうぜん	unprecedented
方	ほう	direction, side (of an argument, etc.), type, field (of study, etc.), indicates one side of a comparison, way, length (of each side of a square)
下がり	さがり	fall, string apron, food offering to the gods, leaving (one's master's place for home), a little after ...
つくっ	つく	to arrive at, to sit on
広げる	ひろげる	to spread, to unfold, to scatter about, to make flourish
られる	れる	indicates passive voice (incl. the "suffering passive"), indicates the potential form, indicates spontaneous occurrence, used as an honorific for others' actions
落ち込ん	おちこむ	to feel down, to be in a slump (business, economy, etc.), to fall into (e.g. a hole)
アトラス	アトラス	Atlas, atlas
消失	しょうしつ	disappearance
色	いろ	colour, complexion, look (on one's face), appearance, personality, tone (of one's voice, etc.), love, lover, beauty, kind, Color
スラブ	スラブ	Slav, slab, Slab
群	ぐん	group, group
程度	ていど	degree
適度	てきど	moderate (degree)
歩	あゆみ	walking, pace, course (of history, one's life, etc.), pitch (of a screw, etc.)
乾漆	かんしつ	dried lacquer, dry lacquer (technique)
起こす	おこす	to raise, to wake, to cause, to start, to plough, to fall ill with, to transcribe, to turn over (a card)
低下	ていか	fall
平等	びょうどう	equality, Byoudou, Equality
深く	ふかく	deeply
持つ	もつ	to hold (in one's hand), to possess, to maintain, to last, to take charge of, to hold (meeting, etc.)
太陽	たいよう	sun, Sun
差し込む	さしこむ	to insert, to have a griping pain, to flow in
とっ	とっ	very
メートル	メートル	metre, meter, Rice
人権	じんけん	human rights, Human rights
異例	いれい	exceptional
不	ふ	un-
物資	ぶっし	goods
なっ	なっとく	consent, understanding
先祖	せんぞ	ancestor, Ancestor
強い	つよい	strong, strong, good (at), being able to handle, firm, intense, dependable
遂げる	とげる	to accomplish, to arrive at (a certain outcome)
やりとり	やりとり	giving and taking
れる	れる	indicates passive voice (incl. the "suffering passive"), indicates the potential form, indicates spontaneous occurrence, used as an honorific for others' actions
上層	じょうそう	upper stratum (classes, stories, storeys)
燃料	ねんりょう	fuel, Fuel
自ら	みずから	oneself, oneself
生む	うむ	to give birth, to produce
船	ふね	ship, tank, counter for boat-shaped containers (e.g. of sashimi), Ship
訪れ	おとずれ	visit, arrival (e.g. of spring), news
原因	げんいん	cause
入れ替わる	いれかわる	to change places
絵	え	picture, image (TV, film, etc.)
安定	あんてい	stability, Stability
塊	かたまり	lump, group, embodiment (of an idea, quality, feeling etc.)
竜騎	りゅうきへい	dragoon, Dragoon
エントロピー	エントロピー	entropy, entropy (information theory), Entropy
使っ	つかってあらわす	to express ... in terms of ...
非常	ひじょう	emergency, extraordinary
君臨	くんりん	reigning
各	かく	each
きっかけ	きっかけ	chance, Kikkake
眼鏡	めがね	glasses, judgment, Megane, Glasses
物質	ぶっしつ	material, matter, Matter
岩塩	がんえん	halite, Halite
海水	かいすい	seawater, Seawater
汚染	おせん	pollution
玄武	げんぶ	Black Tortoise (god said to rule over the northern heavens), seven mansions (Chinese constellations) of the northern heavens, Black Tortoise
革新	かくしん	reform, Reform
菊	きく	chrysanthemum (Chrysanthemum morifolium)
過ぎ	すぎ	past, too (much)
水分	すいぶん	water, Moisture
強大	きょうだい	mighty
共通	きょうつう	common, to be common (to), -wide
ロボット	ロボット	robot, (mere) puppet, Robot
連合	れんごう	union, RENGO (Japanese Trade Union Confederation), Rengou
